pid,station_name,station_lat,station_lng,flows_in,flows_out,flows_all
1,Albany Ave & Montrose Ave,41.961041,-87.705866,353,326,679
2,Sawyer Ave & Irving Park Rd,41.95358618,-87.7093108,332,319,651
3,Jeffery Blvd & 71st St,41.76663824,-87.57645011,155,155,310
4,Jeffery Blvd & 76th St,41.75712007,-87.57583936,41,44,85
5,Stony Island Ave & 71st St,41.76649294,-87.58646088,59,51,110
6,Stony Island Ave & 75th St,41.75866967,-87.58688287,41,43,84
7,Conservatory Dr & Lake St,41.885502,-87.716866,216,235,451
8,Kedzie Ave & Lake St,41.88460329,-87.70630374,222,223,445
9,Sacramento Blvd & Franklin Blvd,41.89046879,-87.70260751,160,170,330
10,Adler Planetarium,41.866095,-87.607267,2983,2731,5714
11,Burnham Harbor,41.856268,-87.613348,4361,4407,8768
12,Calumet Ave & 18th St,41.857611,-87.619407,2879,2796,5675
13,Calumet Ave & 21st St,41.85418425,-87.61915374,1091,1120,2211
14,Field Museum,41.86529817,-87.6182625,1387,1434,2821
15,Indiana Ave & Roosevelt Rd,41.867888,-87.623041,5450,5480,10930
16,McCormick Place,41.85137517,-87.61883465,1099,1071,2170
17,Michigan Ave & 14th St,41.86453567,-87.6236155,3108,2873,5981
18,Michigan Ave & 18th St,41.857813,-87.62455,3334,3013,6347
19,Shedd Aquarium,41.86722596,-87.61535539,3812,3531,7343
20,State St & 19th St,41.856594,-87.627542,911,843,1754
21,Wabash Ave & 16th St,41.86035883,-87.62580483,3585,3277,6862
22,Wabash Ave & Cermak Rd,41.852619,-87.626488,1144,976,2120
23,Wabash Ave & Roosevelt Rd,41.86702317,-87.62592967,7725,7445,15170
24,Clark St & 9th St (AMLI),41.870816,-87.631246,1643,1412,3055
25,Delano Ct & Roosevelt Rd,41.867491,-87.63219,2126,2338,4464
26,Wabash Ave & 9th St,41.8707485,-87.62577717,4182,4349,8531
27,South Shore Dr & 71st St,41.766409,-87.565688,244,276,520
28,Yates Blvd & 75th St,41.758768,-87.56644,79,66,145
29,Bennett Ave & 79th St,41.751785,-87.578496,17,24,41
30,Stony Island Ave & South Chicago Ave,41.751173,-87.585337,15,16,31
31,Damen Ave & Pershing Rd,41.823192,-87.676597,80,54,134
32,Leavitt St & Archer Ave,41.82879202,-87.68060446,312,264,576
33,Wood St & 35th St,41.83015683,-87.67045933,173,154,327
34,Central Park Blvd & 5th Ave,41.875679,-87.71547,22,25,47
35,Kedzie Ave & Harrison St,41.87359967,-87.70487075,23,19,42
36,Kedzie Ave & Roosevelt Rd,41.86649278,-87.70649618,74,58,132
37,Clinton St & 18th St,41.85795,-87.640826,733,659,1392
38,Normal Ave & Archer Ave,41.849527,-87.640591,450,429,879
39,Wells St & 19th St,41.856802,-87.633879,546,489,1035
40,South Shore Dr & 74th St,41.7622205,-87.55923533,188,180,368
41,Phillips Ave & 79th St,41.75182,-87.565211,21,19,40
42,Exchange Ave & 79th St,41.751731,-87.552812,135,134,269
43,Rainbow Beach,41.75787145,-87.54938625,33,37,70
44,Ashland Ave & Pershing Rd,41.823465,-87.665577,138,114,252
45,Emerald Ave & 28th St,41.84358,-87.645368,564,555,1119
46,Emerald Ave & 31st St,41.83823717,-87.6450795,1210,1077,2287
47,Halsted St & Archer Ave,41.847203,-87.646795,422,456,878
48,Shields Ave & 28th Pl,41.842733,-87.635491,406,349,755
49,Shields Ave & 31st St,41.838464,-87.635406,779,840,1619
50,Wentworth Ave & 33rd St,41.8345715,-87.63175467,652,592,1244
51,Morgan St & 31st St,41.8378,-87.65114,582,495,1077
52,Canal St & Adams St,41.879255,-87.639904,20400,23506,43906
53,Canal St & Madison St,41.882091,-87.639833,10054,12052,22106
54,Clinton St & Lake St,41.88515,-87.640207,7760,7671,15431
55,Clinton St & Madison St,41.882242,-87.641066,16266,19886,36152
56,Clinton St & Washington Blvd,41.88338,-87.64117,16051,15979,32030
57,Desplaines St & Jackson Blvd,41.87828,-87.64414817,5298,5284,10582
58,Desplaines St & Kinzie St,41.88871604,-87.64444785,5903,6629,12532
59,Desplaines St & Randolph St,41.88461619,-87.64457058,3734,3840,7574
60,Franklin St & Lake St,41.885575,-87.6357775,4914,4966,9880
61,Franklin St & Monroe St,41.880317,-87.635185,10659,12041,22700
62,Green St & Madison St,41.881892,-87.648789,6524,6125,12649
63,Green St & Randolph St,41.883668,-87.64867,5831,5236,11067
64,Jefferson St & Monroe St,41.880422,-87.642746,2890,3050,5940
65,Kingsbury St & Kinzie St,41.88917683,-87.63850577,12152,12034,24186
66,LaSalle St & Washington St,41.882664,-87.63253,3151,3609,6760
67,Orleans St & Merchandise Mart Plaza,41.888243,-87.63639,7979,11254,19233
68,Wacker Dr & Washington St,41.8832532,-87.63651252,5488,5599,11087
69,Cottage Grove Ave & 83rd St,41.743441,-87.604836,45,30,75
70,MLK Jr Dr & 83rd St,41.743116,-87.6148,58,43,101
71,State St & 29th St,41.8417035,-87.62698683,164,209,373
72,State St & 33rd St,41.834734,-87.625813,3265,3260,6525
73,State St & 35th St,41.83103631,-87.62679756,1583,1386,2969
74,Wallace St & 35th St,41.830629,-87.64129,577,553,1130
75,Wentworth Ave & 35th St,41.830777,-87.632504,542,516,1058
76,Indiana Ave & 26th St,41.845687,-87.622481,765,776,1541
77,Indiana Ave & 31st St,41.838842,-87.621857,1400,1523,2923
78,MLK Jr Dr & 29th St,41.842052,-87.617,3969,3952,7921
79,Cottage Grove Ave & 78th St,41.75316883,-87.60501333,34,33,67
80,Ellis Ave & 83rd St,41.744123,-87.599034,10,10,20
81,Greenwood Ave & 79th St,41.751294,-87.597552,13,8,21
82,Wabash Ave & 83rd St,41.743316,-87.622849,26,41,67
83,Wabash Ave & 87th St,41.736646,-87.622634,27,31,58
84,State St & 79th St,41.750794,-87.624424,75,92,167
85,Loomis St & Archer Ave,41.84163254,-87.65743495,200,212,412
86,Ashland Ave & Archer Ave,41.83920868,-87.66560986,150,166,316
87,Halsted St & 37th St,41.82715217,-87.645796,197,192,389
88,Racine Ave & 35th St,41.830696,-87.655976,309,270,579
89,Calumet Ave & 33rd St,41.8349,-87.61793,1027,1085,2112
90,Calumet Ave & 35th St,41.831379,-87.618034,387,382,769
91,Fort Dearborn Dr & 31st St,41.838556,-87.608218,2210,2221,4431
92,Lake Park Ave & 35th St,41.831274,-87.608799,491,480,971
93,Rhodes Ave & 32nd St,41.8367245,-87.61329067,649,611,1260
94,Indiana Ave & 40th St,41.82167267,-87.62141583,175,186,361
95,MLK Jr Dr & Pershing Rd,41.8246,-87.61678,364,329,693
96,Morgan St & Pershing Rd,41.823613,-87.650931,31,26,57
97,Cottage Grove Ave & Oakwood Blvd,41.82293083,-87.60715483,353,343,696
98,Union Ave & Root St,41.819102,-87.643278,163,125,288
99,Western Ave & Congress Pkwy,41.874749,-87.686445,667,711,1378
100,Western Ave & Monroe St,41.87976367,-87.6860585,395,339,734
101,Stony Island Ave & 82nd St,41.746559,-87.586005,19,23,42
102,Woodlawn Ave & Lake Park Ave,41.81408633,-87.59701383,321,341,662
103,Cottage Grove Ave & 43rd St,41.816499,-87.606582,203,183,386
104,Ashland Ave & McDowell Ave,41.80886717,-87.66449283,121,116,237
105,Hoyne Ave & 47th St,41.808227,-87.67718,130,106,236
106,Marshfield Ave & 44th St,41.813996,-87.666589,37,25,62
107,Elizabeth St & 47th St,41.80839,-87.656526,70,65,135
108,Halsted St & 47th Pl,41.80813391,-87.64561655,96,84,180
109,Laramie Ave & Madison St,41.880207,-87.755337,15,11,26
110,Cicero Ave & Lake St,41.886841,-87.745261,28,22,50
111,Cicero Ave & Quincy St,41.87762117,-87.74538767,3,3,6
112,Kenton Ave & Madison St,41.880708,-87.741018,3,5,8
113,Laramie Ave & Kinzie St,41.887832,-87.755527,28,28,56
114,Austin Blvd & Lake St,41.8878915,-87.774446,73,96,169
115,Central Ave & Lake St,41.887664,-87.765469,29,34,63
116,Central Ave & Madison St,41.880121,-87.763238,9,12,21
117,Austin Blvd & Madison St,41.88026767,-87.77443483,27,63,90
118,Broadway & Ridge Ave,41.98404461,-87.66027383,1682,1568,3250
119,Lakefront Trail & Bryn Mawr Ave,41.9840367,-87.65231047,3347,3129,6476
120,Clark St & Elm St,41.902973,-87.63128,9347,9055,18402
121,Clark St & Schiller St,41.907993,-87.631501,4195,4214,8409
122,Ritchie Ct & Banks St,41.90690183,-87.62591383,2731,2763,5494
123,Rush St & Cedar St,41.9023087,-87.62769053,4199,4337,8536
124,Christiana Ave & Lawrence Ave,41.96835449,-87.71183067,524,490,1014
125,Kedzie Ave & Leland Ave,41.96668636,-87.70805198,537,518,1055
126,Manor Ave & Leland Ave,41.965875,-87.700825,432,431,863
127,Laramie Ave & Gladys Ave,41.87579717,-87.7553165,11,11,22
128,Pulaski Rd & Congress Pkwy,41.874325,-87.725704,67,47,114
129,Karlov Ave & Madison St,41.88085,-87.727907,84,68,152
130,MLK Jr Dr & 63rd St,41.780148,-87.61601633,51,42,93
131,Wentworth Ave & 63rd St,41.78005617,-87.629786,62,94,156
132,Fairfield Ave & Roosevelt Rd,41.866624,-87.694521,166,170,336
133,Ogden Ave & Roosevelt Rd,41.8665205,-87.684537,871,802,1673
134,California Ave & 21st St,41.85380407,-87.6957424,433,432,865
135,Kedzie Ave & 21st St,41.85353363,-87.70507303,150,143,293
136,Eberhart Ave & 61st St,41.784096,-87.61325717,84,72,156
137,Cottage Grove Ave & 51st St,41.803038,-87.606615,214,253,467
138,Ellis Ave & 53rd St,41.79933626,-87.60095811,1258,1276,2534
139,Ellis Ave & 55th St,41.794301,-87.60145,2624,2708,5332
140,University Ave & 57th St,41.791478,-87.599861,3681,3539,7220
141,Woodlawn Ave & 55th St,41.795264,-87.596471,1117,1111,2228
142,Blackstone Ave & Hyde Park Blvd,41.802562,-87.590368,904,958,1862
143,Cornell Ave & Hyde Park Blvd,41.802406,-87.586924,1462,1473,2935
144,Kimbark Ave & 53rd St,41.799568,-87.594747,2358,2370,4728
145,Lake Park Ave & 53rd St,41.799602,-87.5862475,1329,1211,2540
146,DuSable Museum,41.791568,-87.607852,172,182,354
147,Lake Park Ave & 56th St,41.793242,-87.587782,1528,1417,2945
148,Museum of Science and Industry,41.79172821,-87.58394501,836,795,1631
149,Kostner Ave & Adams St,41.877917,-87.735737,50,49,99
150,900 W Harrison St,41.87470983,-87.649808,1906,1974,3880
151,Canal St & Harrison St,41.87427417,-87.63955583,955,1149,2104
152,Canal St & Jackson Blvd,41.877245,-87.639366,4388,4231,8619
153,Clinton St & Tilden St,41.875885,-87.640795,2236,2275,4511
154,Franklin St & Jackson Blvd,41.87770796,-87.63532114,5955,6057,12012
155,LaSalle St & Adams St,41.87934437,-87.63198522,1844,1899,3743
156,LaSalle St & Jackson Blvd,41.8777575,-87.63174117,9017,10096,19113
157,Peoria St & Jackson Blvd,41.877642,-87.649618,4536,4659,9195
158,Aberdeen St & Jackson Blvd,41.87772613,-87.65478743,4296,4362,8658
159,Canal St & Taylor St,41.870257,-87.639474,2470,2448,4918
160,Clinton St & Roosevelt Rd,41.867069,-87.64099333,2449,2246,4695
161,Federal St & Polk St,41.87217883,-87.62953633,4584,4272,8856
162,Halsted St & Maxwell St,41.86480467,-87.647099,2354,2255,4609
163,Halsted St & Polk St,41.87184,-87.64664,2991,3040,6031
164,Halsted St & Roosevelt Rd,41.867324,-87.648625,1979,1854,3833
165,May St & Taylor St,41.8694821,-87.6554864,3839,3777,7616
166,Morgan St & Polk St,41.871737,-87.65103,5204,5260,10464
167,Racine Ave & Congress Pkwy,41.87464,-87.65703,2243,2194,4437
168,Wells St & Polk St,41.872596,-87.633502,2601,2373,4974
169,South Chicago Ave & 83rd St,41.74389717,-87.57524517,8,10,18
170,Commercial Ave & 83rd St,41.744615,-87.551208,32,27,59
171,Halsted St & 51st St,41.80183164,-87.6452139,17,17,34
172,Princeton Ave & 47th St,41.80931771,-87.63344929,112,166,278
173,Ashland Ave & 50th St,41.803023,-87.664699,28,26,54
174,Throop St & 52nd St,41.799659,-87.657195,1,1,2
175,Central Ave & Harrison St,41.872993,-87.764499,19,21,40
176,Cicero Ave & Flournoy St,41.872131,-87.746619,14,16,30
177,Aberdeen St & Monroe St,41.88046817,-87.65557133,3673,3440,7113
178,Loomis St & Jackson Blvd,41.877945,-87.662007,1497,1486,2983
179,Loomis St & Lexington St,41.872187,-87.661501,4071,4178,8249
180,Hermitage Ave & Polk St,41.871514,-87.669886,2015,1977,3992
181,Ogden Ave & Congress Pkwy,41.87501,-87.67328,447,547,994
182,Wolcott Ave & Polk St,41.87131183,-87.67370583,3053,2924,5977
183,MLK Jr Dr & 47th St,41.80987767,-87.61633967,129,133,262
184,Prairie Ave & 43rd St,41.81665889,-87.61941246,167,148,315
185,Shields Ave & 43rd St,41.8161935,-87.63478517,10,10,20
186,State St & Pershing Rd,41.82305467,-87.626579,85,86,171
187,Cottage Grove Ave & 47th St,41.809855,-87.606755,236,253,489
188,Phillips Ave & 83rd St,41.744531,-87.56506,15,17,32
189,Calumet Ave & 51st St,41.802295,-87.618054,191,202,393
190,Damen Ave & 51st St,41.800908,-87.674684,18,20,38
191,Ashland Ave & Garfield Blvd,41.792822,-87.664429,9,5,14
192,Seeley Ave & Garfield Blvd,41.7941445,-87.67551733,8,8,16
193,Western Blvd & 48th Pl,41.805661,-87.683392,63,105,168
194,Austin Blvd & Chicago Ave,41.894887,-87.774704,47,49,96
195,Central Ave & Chicago Ave,41.894958,-87.764902,15,14,29
196,Princeton Ave & Garfield Blvd,41.794982,-87.633124,84,86,170
197,Ellis Ave & 58th St,41.788746,-87.601334,1773,1795,3568
198,Ellis Ave & 60th St,41.78509715,-87.60107276,2711,2753,5464
199,63rd St Beach,41.78091096,-87.57632375,264,279,543
200,Dorchester Ave & 63rd St,41.78040565,-87.59141599,153,133,286
201,Jeffery Blvd & 67th St,41.77351755,-87.57714283,83,79,162
202,South Shore Dr & 67th St,41.773643,-87.567514,236,224,460
203,Stony Island Ave & 64th St,41.778881,-87.586647,73,80,153
204,Stony Island Ave & 67th St,41.7734585,-87.58533974,51,48,99
205,Cottage Grove Ave & 63rd St,41.780601,-87.605836,211,204,415
206,California Ave & 23rd Pl,41.84910969,-87.69513981,426,443,869
207,Central Park Ave & 24th St,41.8481,-87.715068,39,49,88
208,Central Park Ave & Ogden Ave,41.8540635,-87.71511734,66,73,139
209,Millard Ave & 26th St,41.84453112,-87.715922,133,131,264
210,Damen Ave & Cullerton St,41.85496383,-87.6755935,742,678,1420
211,Western Ave & 21st St,41.854109,-87.685838,459,463,922
212,Damen Ave & Coulter St,41.8492,-87.67564,110,119,229
213,Western Ave & 24th St,41.84845817,-87.68515583,205,191,396
214,Cottage Grove Ave & 67th St,41.773721,-87.605635,100,96,196
215,Albany Ave & 26th St,41.84447501,-87.70201301,56,56,112
216,Kedzie Ave & 24th St,41.84819094,-87.70541375,65,95,160
217,Buckingham Fountain,41.87653519,-87.62047291,1150,1340,2490
218,Clark St & Lake St,41.88602083,-87.63087606,4933,5102,10035
219,Clark St & Randolph St,41.88426883,-87.631596,5103,4941,10044
220,Columbus Dr & Randolph St,41.884728,-87.619521,7710,11065,18775
221,Daley Center Plaza,41.88417233,-87.62920067,12639,13032,25671
222,Dearborn St & Adams St,41.87866733,-87.6301535,3271,3395,6666
223,Dearborn St & Monroe St,41.88131982,-87.62952092,5935,5947,11882
224,Dusable Harbor,41.886976,-87.612813,2818,2830,5648
225,Field Blvd & South Water St,41.88634906,-87.61751655,3670,3487,7157
226,Michigan Ave & Jackson Blvd,41.87785,-87.62408,3799,3762,7561
227,Michigan Ave & Lake St,41.886024,-87.624117,6253,6291,12544
228,Michigan Ave & Madison St,41.882134,-87.625125,3239,3124,6363
229,Michigan Ave & Washington St,41.88398406,-87.62468398,12249,12818,25067
230,Millennium Park,41.8810317,-87.62408432,7463,7427,14890
231,State St & Randolph St,41.8845995,-87.62737167,5692,5991,11683
232,Stetson Ave & South Water St,41.886835,-87.62232,3546,3873,7419
233,Wabash Ave & Adams St,41.87947235,-87.62568861,3520,3190,6710
234,Wabash Ave & Wacker Pl,41.886875,-87.62603,3223,3651,6874
235,California Ave & 26th St,41.84405883,-87.695358,114,98,212
236,Halsted St & 21st St,41.85381567,-87.64657583,559,464,1023
237,May St & Cullerton St,41.855136,-87.654127,701,730,1431
238,Cityfront Plaza Dr & Pioneer Ct,41.89039817,-87.6220405,3517,3972,7489
239,Fairbanks Ct & Grand Ave,41.89184737,-87.6205802,6765,7005,13770
240,LaSalle St & Illinois St,41.890762,-87.631697,6445,6104,12549
241,Rush St & Hubbard St,41.890173,-87.626185,4065,3781,7846
242,State St & Kinzie St,41.8892055,-87.627837,6297,5935,12232
243,Wabash Ave & Grand Ave,41.891466,-87.626761,6380,6789,13169
244,Michigan Ave & 8th St,41.872773,-87.623981,2145,2668,4813
245,State St & Harrison St,41.874053,-87.627716,2624,2958,5582
246,State St & Van Buren St,41.87717417,-87.6278235,3338,3541,6879
247,Woodlawn Ave & 75th St,41.75916,-87.595751,11,11,22
248,Morgan Ave & 14th Pl,41.862378,-87.651062,1727,1624,3351
249,Morgan St & 18th St,41.85805783,-87.65114933,1558,1336,2894
250,Racine Ave & 15th St,41.861267,-87.656625,972,947,1919
251,Racine Ave & 18th St,41.858166,-87.656495,1605,1444,3049
252,Blue Island Ave & 18th St,41.857556,-87.661535,1872,1694,3566
253,Paulina St & 18th St,41.857901,-87.668745,1171,1164,2335
254,Harper Ave & 59th St,41.78796817,-87.58828167,695,786,1481
255,Shore Dr & 55th St,41.79529467,-87.58090567,2634,2657,5291
256,Pulaski Rd & Lake St,41.885409,-87.726491,17,30,47
257,Glenwood Ave & Morse Ave,42.00796267,-87.66543183,1368,1360,2728
258,Glenwood Ave & Touhy Ave,42.012701,-87.666058,283,280,563
259,Sheridan Rd & Greenleaf Ave,42.010587,-87.662412,605,594,1199
260,Bosworth Ave & Howard St,42.019537,-87.669563,208,219,427
261,Eastlake Ter & Rogers Ave,42.02085367,-87.66500883,609,657,1266
262,Greenview Ave & Jarvis Ave,42.015962,-87.66857,682,660,1342
263,Paulina St & Howard St,42.019159,-87.673573,792,695,1487
264,Broadway & Barry Ave,41.93758232,-87.64409781,6560,6506,13066
265,Broadway & Belmont Ave,41.940106,-87.645451,4843,4015,8858
266,Clark St & Columbia Ave,42.00445063,-87.6724024,595,592,1187
267,Clark St & Lunt Ave,42.009074,-87.67419,1024,938,1962
268,Warren Park East,42.00455317,-87.68065967,254,243,497
269,Clark St & Touhy Ave,42.01256012,-87.67436712,125,116,241
270,Ridge Blvd & Touhy Ave,42.01213228,-87.68291264,212,237,449
271,Clark St & Jarvis Ave,42.0159795,-87.675008,270,278,548
272,Oakley Ave & Touhy Ave,42.012342,-87.688243,89,72,161
273,Ridge Blvd & Howard St,42.0193035,-87.68460283,170,203,373
274,Western Ave & Howard St,42.018901,-87.690048,208,204,412
275,Wolcott Ave & Fargo Ave,42.016977,-87.677725,52,63,115
276,Central Park Ave & Elbridge Ave,41.93533728,-87.71688929,453,503,956
277,Kedzie Ave & Milwaukee Ave,41.9295265,-87.70785083,3692,3418,7110
278,Kimball Ave & Belmont Ave,41.939398,-87.711561,544,478,1022
279,Sheridan Rd & Loyola Ave,42.00104378,-87.66119824,1283,1213,2496
280,Carpenter St & Huron St,41.89455,-87.65340333,2028,2268,4296
281,Eckhart Park,41.89637337,-87.66098386,2679,2505,5184
282,Halsted St & North Branch St,41.89936844,-87.64847988,765,805,1570
283,Kingsbury St & Erie St,41.89380806,-87.64169723,6731,7078,13809
284,Larrabee St & Kingsbury St,41.897764,-87.642884,7590,6861,14451
285,Milwaukee Ave & Grand Ave,41.891578,-87.648384,4700,4901,9601
286,Ogden Ave & Chicago Ave,41.89636246,-87.65406127,3132,3220,6352
287,Ogden Ave & Race Ave,41.891795,-87.658751,2946,2638,5584
288,Morgan St & Lake St,41.88548867,-87.6522495,6172,5324,11496
289,Kostner Ave & Lake St,41.885928,-87.73541,6,8,14
290,Halsted St & 69th St,41.76906172,-87.64461358,92,85,177
291,Perry Ave & 69th St,41.76929309,-87.62819593,52,51,103
292,Calumet Ave & 71st St,41.76550801,-87.61691793,15,15,30
293,Cottage Grove Ave & 71st St,41.76571904,-87.60495971,26,29,55
294,State St & 76th St,41.75698217,-87.62460517,22,29,51
295,Clark St & Schreiber Ave,41.9993005,-87.67138933,549,530,1079
296,Dearborn St & Erie St,41.893992,-87.629318,8352,8461,16813
297,McClurg Ct & Erie St,41.894503,-87.617854,5213,5249,10462
298,Michigan Ave & Pearson St,41.89766,-87.62351,2523,2842,5365
299,Mies van der Rohe Way & Chicago Ave,41.89691,-87.621743,4350,4450,8800
300,Rush St & Superior St,41.89576475,-87.62590803,3856,4134,7990
301,St. Clair St & Erie St,41.89434514,-87.62279838,7952,5772,13724
302,Streeter Dr & Grand Ave,41.892278,-87.612043,14533,14239,28772
303,Western Ave & Lunt Ave,42.008594,-87.690492,340,350,690
304,Broadway & Granville Ave,41.99477969,-87.66028453,1526,1388,2914
305,Broadway & Thorndale Ave,41.98974251,-87.66014062,1579,1408,2987
306,Warren Park West,42.001785,-87.688829,222,200,422
307,Broadway & Berwyn Ave,41.978353,-87.659753,2133,1986,4119
308,Broadway & Argyle St,41.973815,-87.65966,1952,1814,3766
309,Clarendon Ave & Leland Ave,41.96792417,-87.64996317,1450,1402,2852
310,Lakefront Trail & Wilson Ave,41.965845,-87.645361,93,115,208
311,Marine Dr & Ainslie St,41.9716,-87.650154,1654,1543,3197
312,Sheridan Rd & Lawrence Ave,41.969517,-87.654691,1396,1265,2661
313,Western Ave & Granville Ave,41.99416137,-87.68943828,217,182,399
314,Winthrop Ave & Lawrence Ave,41.968812,-87.657659,1607,1600,3207
315,Vernon Ave & 75th St,41.758361,-87.614138,19,36,55
316,Broadway & Cornelia Ave,41.945529,-87.646439,4374,4215,8589
317,Broadway & Sheridan Rd,41.952833,-87.649993,2132,2235,4367
318,Broadway & Waveland Ave,41.949074,-87.648636,3769,3484,7253
319,Halsted St & Roscoe St,41.94367,-87.64895,4475,4365,8840
320,Pine Grove Ave & Waveland Ave,41.94947274,-87.64645278,3896,3752,7648
321,Pine Grove Ave & Irving Park Rd,41.95430133,-87.647923,3506,3643,7149
322,Sheffield Ave & Waveland Ave,41.949399,-87.654529,5410,4846,10256
323,Albany Ave & Bloomingdale Ave,41.91396333,-87.7051555,1233,1160,2393
324,California Ave & North Ave,41.91044,-87.6972,954,821,1775
325,Humboldt Blvd & Armitage Ave,41.91751339,-87.70180896,1300,1241,2541
326,Halsted St & 56th St,41.79292965,-87.64499006,29,37,66
327,Damen Ave & 59th St,41.78586107,-87.67414391,6,6,12
328,Budlong Woods Library,41.98366471,-87.69642256,117,96,213
329,Francisco Ave & Foster Ave,41.97566833,-87.70141617,470,437,907
330,Lincoln Ave & Winona St,41.9749113,-87.69250256,497,562,1059
331,Ashland Ave & 63rd St,41.7793725,-87.6649875,24,24,48
332,Ashland Ave & 66th St,41.77411467,-87.66376733,6,7,13
333,Racine Ave & 65th St,41.775393,-87.654308,7,10,17
334,Clark St & North Ave,41.911974,-87.631942,3310,3201,6511
335,Wells St & Concord Ln,41.912133,-87.634656,8516,8085,16601
336,Wells St & Evergreen Ave,41.906724,-87.63483,4649,4578,9227
337,Dearborn Pkwy & Delaware Pl,41.899134,-87.6298595,6141,6122,12263
338,Wells St & Elm St,41.903222,-87.634324,4911,4625,9536
339,Wells St & Walton St,41.89993001,-87.63443007,1661,2426,4087
340,Michigan Ave & Oak St,41.90096039,-87.62377664,7952,7639,15591
341,Mies van der Rohe Way & Chestnut St,41.89858665,-87.62191523,4231,4351,8582
342,State St & Pearson St,41.897448,-87.628722,3532,4094,7626
343,Ashland Ave & 13th St,41.86528417,-87.666564,1026,899,1925
344,Clark St & Wrightwood Ave,41.929546,-87.643118,5618,5526,11144
345,Lakeview Ave & Fullerton Pkwy,41.92594583,-87.63906,5048,4848,9896
346,Larrabee St & Webster Ave,41.921822,-87.64414,4571,4433,9004
347,Lincoln Ave & Fullerton Ave,41.925905,-87.64926,3440,3387,6827
348,Sedgwick St & Webster Ave,41.922167,-87.638888,4221,4270,8491
349,Maplewood Ave & Peterson Ave,41.990236,-87.69337,120,134,254
350,Ashland Ave & Wellington Ave,41.936083,-87.669807,1427,1263,2690
351,Ashland Ave & Wrightwood Ave,41.92883,-87.668507,1851,1858,3709
352,Greenview Ave & Diversey Pkwy,41.93258963,-87.66593635,1409,1338,2747
353,Lincoln Ave & Diversey Pkwy,41.932225,-87.658617,2862,2863,5725
354,Southport Ave & Belmont Ave,41.93947775,-87.66374767,1945,2053,3998
355,Southport Ave & Wellington Ave,41.93557517,-87.663731,4010,4007,8017
356,Southport Ave & Wrightwood Ave,41.928773,-87.663913,2333,2275,4608
357,Campbell Ave & North Ave,41.9105165,-87.68951667,1266,1238,2504
358,Milwaukee Ave & Rockwell St,41.92019556,-87.6926592,1135,971,2106
359,Stave St & Armitage Ave,41.91767067,-87.69153617,749,790,1539
360,Western Ave & Winnebago Ave,41.91552,-87.687022,2607,2702,5309
361,Campbell Ave & Fullerton Ave,41.92463247,-87.68930701,900,860,1760
362,Damen Ave & Charleston St,41.92010133,-87.67784333,1646,1638,3284
363,Leavitt St & Armitage Ave,41.917805,-87.682437,1390,1482,2872
364,Winchester Ave & Elston Ave,41.92409085,-87.67646007,1408,1269,2677
365,Damen Ave & Cortland St,41.915983,-87.677335,3086,3046,6132
366,Milwaukee Ave & Wabansia Ave,41.912616,-87.681391,3458,3318,6776
367,Walsh Park,41.91461,-87.667968,75,83,158
368,Leavitt St & North Ave,41.91016083,-87.68239917,1514,1487,3001
369,Spaulding Ave & Armitage Ave,41.9171195,-87.71024583,1190,1070,2260
370,Clark St & Berwyn Ave,41.97803567,-87.66807783,2830,2767,5597
371,Ashland Ave & Augusta Blvd,41.89966017,-87.66848083,2339,2194,4533
372,Ashland Ave & Blackhawk St,41.907066,-87.667252,2706,2661,5367
373,Ashland Ave & Chicago Ave,41.895966,-87.667747,2554,2504,5058
374,Ashland Ave & Division St,41.90350133,-87.66779133,6694,6817,13511
375,Damen Ave & Thomas St (Augusta Blvd),41.90135617,-87.6776705,2439,2394,4833
376,Honore St & Division St,41.90314433,-87.67384317,2693,2759,5452
377,Wood St & Augusta Blvd,41.899181,-87.6722,212,195,407
378,Wood St & Milwaukee Ave,41.907655,-87.672552,4011,3849,7860
379,Damen Ave & Chicago Ave,41.895769,-87.67722,4187,3609,7796
380,Damen Ave & Division St,41.903266,-87.678435,2549,2467,5016
381,Kedzie Ave & Bryn Mawr Ave,41.98239708,-87.70892252,181,127,308
382,Kedzie Ave & Foster Ave,41.97566317,-87.70923017,285,270,555
383,St. Louis Ave & Balmoral Ave,41.98039423,-87.71611496,232,222,454
384,Ashland Ave & Belle Plaine Ave,41.956057,-87.668835,294,322,616
385,Ashland Ave & Grace St,41.950687,-87.6687,1476,1505,2981
386,Clark St & Grace St,41.95078,-87.659172,2703,2734,5437
387,Clark St & Montrose Ave,41.961588,-87.666036,1544,1577,3121
388,Southport Ave & Clark St,41.957081,-87.664199,952,1029,1981
389,Southport Ave & Irving Park Rd,41.954177,-87.664358,1699,1722,3421
390,Marshfield Ave & 59th St,41.786833,-87.666215,8,8,16
391,Richmond St & Diversey Ave,41.93190197,-87.70119513,835,835,1670
392,Clark St & Bryn Mawr Ave,41.983593,-87.669154,1570,1506,3076
393,Damen Ave & Foster Ave,41.9756148,-87.67945904,1199,1220,2419
394,Winchester (Ravenswood) Ave & Balmoral Ave,41.979762,-87.67753,808,750,1558
395,Greenview Ave & Fullerton Ave,41.92533,-87.6658,2851,2551,5402
396,Racine Ave & Fullerton Ave,41.925563,-87.658404,3168,3199,6367
397,Racine Ave & Wrightwood Ave,41.928887,-87.658971,1747,1798,3545
398,Sheffield Ave & Fullerton Ave,41.92560188,-87.65370804,5972,5993,11965
399,Sheffield Ave & Wrightwood Ave,41.928712,-87.653833,2999,2968,5967
400,Wilton Ave & Diversey Pkwy,41.932418,-87.652705,5263,5358,10621
401,Southport Ave & Clybourn Ave,41.920771,-87.663712,3054,2829,5883
402,Damen Ave & Clybourn Ave,41.931931,-87.677856,1493,1283,2776
403,Damen Ave & Wellington Ave,41.93588,-87.67842,1511,1384,2895
404,Logan Blvd & Elston Ave,41.929465,-87.684158,1554,1461,3015
405,Central Park Ave & North Ave,41.90965688,-87.71663195,466,471,937
406,Troy St & North Ave,41.9097693,-87.70528049,432,444,876
407,California Ave & Lake St,41.884459,-87.69629017,195,175,370
408,Avers Ave & Belmont Ave,41.939403,-87.72354367,357,359,716
409,Spaulding Ave & Division St,41.90270659,-87.70921957,316,290,606
410,Leavitt St & Chicago Ave,41.89548667,-87.6820635,123,103,226
411,Western Ave & Division St,41.90291383,-87.68729533,1978,1806,3784
412,Western Ave & Walton St,41.89841769,-87.68659602,2292,2197,4489
413,Clarendon Ave & Gordon Ter,41.95786652,-87.64950514,2745,2749,5494
414,Clarendon Ave & Junior Ter,41.961004,-87.649603,2111,1950,4061
415,Sheridan Rd & Buena Ave,41.958494,-87.654966,1757,1728,3485
416,Sheridan Rd & Irving Park Rd,41.954245,-87.654406,4222,4077,8299
417,Sheridan Rd & Montrose Ave,41.96167,-87.65464,2931,2613,5544
418,Clark St & Leland Ave,41.967096,-87.667429,1755,1964,3719
419,Paulina St & Montrose Ave,41.96148583,-87.6713735,990,1017,2007
420,Damen Ave & Leland Ave,41.967094,-87.679028,1868,1920,3788
421,Damen Ave & Sunnyside Ave,41.96325,-87.679258,952,938,1890
422,Ravenswood Ave & Lawrence Ave,41.9691185,-87.674186,4922,4685,9607
423,Washtenaw Ave & Lawrence Ave,41.968987,-87.696027,567,525,1092
424,Clark St & Armitage Ave,41.918306,-87.636282,7109,6859,13968
425,Clark St & Lincoln Ave,41.915689,-87.6346,6008,6052,12060
426,Halsted St & Willow St,41.913865,-87.648755,2419,2449,4868
427,Larrabee St & Armitage Ave,41.918084,-87.643749,2317,2532,4849
428,Larrabee St & Menomonee St,41.91468,-87.64332,1789,1873,3662
429,Larrabee St & North Ave,41.91021,-87.6435,1425,1476,2901
430,Sedgwick St & North Ave,41.91128633,-87.63867533,4804,5053,9857
431,Bissell St & Armitage Ave,41.91844,-87.65222,5590,5108,10698
432,Clifton Ave & Armitage Ave,41.918216,-87.656936,2737,2652,5389
433,Halsted St & Dickens Ave,41.919936,-87.64883,3722,3429,7151
434,Sheffield Ave & Webster Ave,41.92154,-87.653818,4337,4300,8637
435,Sheffield Ave & Willow St,41.913688,-87.652855,3487,3355,6842
436,Halsted St & Wrightwood Ave,41.929143,-87.649077,3256,3254,6510
437,Sedgwick St & Schiller St,41.907626,-87.638566,1021,1065,2086
438,Dayton St & North Ave,41.91057803,-87.64942193,3859,3879,7738
439,Sheffield Ave & Kingsbury St,41.910522,-87.653106,3994,3610,7604
440,Evans Ave & 75th St,41.75849,-87.60641,94,73,167
441,Clybourn Ave & Division St,41.904613,-87.640552,2329,2313,4642
442,Larrabee St & Division St,41.90348607,-87.64335349,3230,3511,6741
443,Franklin St & Chicago Ave,41.89674697,-87.63566762,4349,4716,9065
444,Larrabee St & Oak St,41.90021949,-87.64298547,3208,3072,6280
445,Orleans St & Chestnut St (NEXT Apts),41.89813083,-87.63745483,2764,3092,5856
446,Sedgwick St & Huron St,41.89458967,-87.63821983,4333,4315,8648
447,Clark St & Chicago Ave,41.89675,-87.63089,3364,3821,7185
448,Milwaukee Ave & Cuyler Ave,41.9544395,-87.7496065,193,157,350
449,Kildare Ave & Montrose Ave,41.96108,-87.73569,26,32,58
450,Knox Ave & Montrose Ave,41.960631,-87.745359,159,183,342
451,California Ave & Montrose Ave,41.961068,-87.695439,507,434,941
452,Campbell Ave & Montrose Ave,41.96152593,-87.69116504,799,739,1538
453,Rockwell St & Eastwood Ave,41.96590014,-87.69363849,765,602,1367
454,Western Ave & Leland Ave,41.9663998,-87.68870428,2261,2047,4308
455,Avondale Ave & Irving Park Rd,41.953393,-87.732002,609,629,1238
456,Kilbourn Ave & Irving Park Rd,41.953733,-87.740569,188,190,378
457,Keystone Ave & Montrose Ave,41.96110802,-87.7289701,356,322,678
458,Drake Ave & Montrose Ave,41.96115408,-87.71656907,523,485,1008
459,Monticello Ave & Irving Park Rd,41.95400484,-87.71912818,351,388,739
460,Leavitt St & Lawrence Ave,41.968885,-87.684001,813,874,1687
461,Lincoln Ave & Sunnyside Ave,41.963006,-87.68482917,1710,1703,3413
462,Drake Ave & Addison St,41.947326,-87.717582,499,511,1010
463,Troy St & Elston Ave,41.94524357,-87.7066499,794,731,1525
464,Pulaski Rd & Eddy St (Temp),41.946264,-87.731023,197,177,374
465,Kilbourn Ave & Milwaukee Ave,41.94707089,-87.74000823,168,205,373
466,Leavitt St & Addison St,41.946655,-87.683359,722,675,1397
467,Lincoln Ave & Waveland Ave,41.948797,-87.675278,1434,1244,2678
468,Oakley Ave & Irving Park Rd,41.95419567,-87.6859995,700,638,1338
469,Lincoln Ave & Addison St,41.946176,-87.673308,870,742,1612
470,Seeley Ave & Roscoe St,41.943403,-87.679618,1135,1094,2229
471,Western Ave & Roscoe St,41.943034,-87.687288,1065,1055,2120
472,Lincoln Ave & Belle Plaine Ave,41.95600355,-87.68016145,1705,1509,3214
473,Ravenswood Ave & Berteau Ave,41.957921,-87.673567,1415,1441,2856
474,Ravenswood Ave & Irving Park Rd,41.95469,-87.67393,1747,1642,3389
475,Lincoln Ave & Roscoe St,41.94334,-87.67097,3271,2862,6133
476,Damen Ave & Melrose Ave,41.9406,-87.6785,1263,1217,2480
477,California Ave & Fletcher St,41.93842879,-87.69800776,725,614,1339
478,Wells St & Hubbard St,41.889906,-87.634266,7279,6716,13995
479,Wells St & Huron St,41.894722,-87.634362,6949,7151,14100
480,Keystone Ave & Fullerton Ave,41.92459,-87.72785,306,286,592
481,California Ave & Cortez St,41.900325,-87.696654,1517,1498,3015
482,California Ave & Division St,41.903029,-87.697474,746,771,1517
483,Lincoln Ave & Belmont Ave,41.939365,-87.668385,2647,2550,5197
484,Racine Ave & Belmont Ave,41.939743,-87.658865,2724,2676,5400
485,Southport Ave & Roscoe St,41.94374133,-87.66396267,5166,4709,9875
486,Clark St & Drummond Pl,41.931248,-87.644336,5016,4198,9214
487,Stockton Dr & Wrightwood Ave,41.93132,-87.638742,4200,3772,7972
488,Cannon Dr & Fullerton Ave,41.926756,-87.634429,1757,1735,3492
489,Montrose Harbor,41.963982,-87.638181,4370,4184,8554
490,Clark St & Wellington Ave,41.93652333,-87.64761533,4286,4089,8375
491,Sheffield Ave & Wellington Ave,41.93629883,-87.65250867,4946,4559,9505
492,Wilton Ave & Belmont Ave,41.94018,-87.65304,6800,6796,13596
493,Halsted St & 59th St,41.787539,-87.644874,13,10,23
494,Racine Ave & 61st St,41.783189,-87.654372,1,1,2
495,May St & 69th St,41.768938,-87.652934,70,77,147
496,Theater on the Lake,41.926277,-87.630834,11114,10625,21739
497,Racine Ave & 13th St,41.865054,-87.656959,397,434,831
498,Kedzie Ave & Chicago Ave,41.8954653,-87.70612788,307,250,557
499,Greenwood Ave & 47th St,41.80975067,-87.59940183,500,513,1013
500,Elston Ave & Wabansia Ave,41.912919,-87.664169,981,959,1940
501,Noble St & Milwaukee Ave,41.90068,-87.6626,2482,2412,4894
502,Paulina Ave & North Ave,41.90985465,-87.66993016,2680,2679,5359
503,Damen Ave & Pierce Ave,41.90939601,-87.67769193,7122,6730,13852
504,Artesian Ave & Hubbard St,41.88949182,-87.68821936,1514,1794,3308
505,Damen Ave & Grand Ave,41.89129117,-87.67681333,2116,2100,4216
506,California Ave & Altgeld St,41.92669,-87.697668,1173,1072,2245
507,California Ave & Milwaukee Ave,41.92267383,-87.69717633,3332,3378,6710
508,Clark St & Elmdale Ave,41.99086045,-87.66972363,795,713,1508
509,Southport Ave & Waveland Ave,41.94815,-87.66394,3876,3747,7623
510,Kedzie Ave & Palmer Ct,41.921525,-87.707322,1159,1169,2328
511,Claremont Ave & Hirsch St,41.907781,-87.685854,895,963,1858
512,Ashland Ave & Grand Ave,41.891072,-87.666611,1619,1438,3057
513,California Ave & Byron St,41.95216219,-87.69805111,501,465,966
514,Prairie Ave & Garfield Blvd,41.794853,-87.618691,453,393,846
515,Dorchester Ave & 49th St,41.805772,-87.592464,228,215,443
516,Lake Park Ave & 47th St,41.809443,-87.591875,520,458,978
517,Racine Ave & Garfield Blvd,41.794228,-87.655073,10,11,21
518,Ada St & Washington Blvd,41.88283,-87.661206,2904,2904,5808
519,Damen Ave & Madison St,41.88137,-87.67493,798,795,1593
520,2112 W Peterson Ave,41.991178,-87.683593,170,138,308
521,Kosciuszko Park,41.93044983,-87.72380583,743,661,1404
522,Aberdeen St & Randolph St,41.884114,-87.654264,3258,3165,6423
523,Racine Ave & Randolph St,41.88404767,-87.65697383,2758,2886,5644
524,Wood St & Hubbard St,41.889899,-87.671473,1365,1391,2756
525,Talman Ave & Addison St,41.94664417,-87.694634,893,797,1690
